##################################################
#...#...#........................................#
#.p.#...#........................................#
#.......#........................................#
#...#...#........................................#
#####...#........................................#
#...#...#........................................#
#...#...#........................................#
#.......#........................................#
#...#...#........................................#
#####...#........................................#
#...#...#........................................#
#...#...#........................................#
#.......#........................................#
#...#...#######..................................#
#####...#........................................#
#...#...#.#####..................................#
#...#...#.#......................................#
#.......#.#.#######..............................#
#...#...#.#.......###............................#
#####...#...###.#................................#
#...#...###.#.#.###..............................#
#...#.......#....................................#
#.......##########################################
#...#.............................................
#####.............................................
#...#...##########################################
#...#...#........................................#
#.......#........................................#
#...#...#........................................#
#####...#........................................#
#...#...#........................................#
#...#...#........................................#
#.......#........................................#
#...#...#........................................#
#####...#........................................#
#...#...#........................................#
#...#...#........................................#
#.......#........................................#
#...#...#........................................#
#####...#........................................#
#...#...#........................................#
#...#...#........................................#
#.......#........................................#
#...#...#........................................#
#####...#........................................#
#.......#........................................#
#.......#........................................#
#.......#........................................#
##################################################